4444444444444444444444
4902000000000000000594
4120000000000000000414
4000000000000000000004
4000000000000000000004
4000000000800000000004
4000000000500000000004
4000000000000000000004
4000000000000000000004
4330000000000000003204
4910000000000000004494
4444444444444444444444