4444444444444444444444
4920000000000006603394
4622000000006000000014
4000000000000000000054
4050400000300000000004
4004400001820000000004
4000000001530000000004
4000000000100000000004
4000000000000000000004
4006600000000000000004
4950000000000000000094
4444444444444444444444