4444444444444444444444
4921066600000000002094
4001000000000000002004
4200000000000000000024
4100001013110000000354
4933300030803100000094
4330000020503000044444
4002220020033000000004
4500000000330000000004
4150000000000550004444
4936600000000000001194
4444444444444444444444