4444444444444444444444
4900000000000000000094
4000000000000444444444
4000000000000007000004
4000000050000000000004
4000000000800000000004
4000322220000000000004
4000000000000000000004
4000000000000000000004
4000000000000020000004
4900000000000010000094
4444444444444444444444