4444444444444444444444
4000540000005000230094
4000040000000000200004
4022240000000000231444
4400040000000000000004
4090000000800000006004
4000600000000007006004
4000000000600000000004
4000000000600000441444
4444444140600000016004
4900000026600000020494
4444444444444444444444